
      ##### #
  ### #B #  #              ####
  # ###  #  #              #  #
  #     ## ###### ##########  #
  #         #               A #
 ##  #####  # #############   #
 #   #   # ## #           #   #
 #   #   #    #           #####
 #####   ######